af - Afrikaans
sq - Albanian
am - Amharic
ar - Arabic
hy - Armenian
az - Azerbaijani
eu - Basque
be - Belarusian
bn - Bengali
bs - Bosnian
bg - Bulgarian
ca - Catalan
zh - Chinese
hr - Croatian
cs - Czech
da - Danish
nl - Dutch
en - English
et - Estonian
fi - Finnish
fr - French
ka - Georgian
de - German
el - Greek
gu - Gujarati
he - Hebrew
hi - Hindi
hu - Hungarian
is - Icelandic
id - Indonesian
ga - Irish
it - Italian
ja - Japanese
kn - Kannada
kk - Kazakh
ko - Korean
lv - Latvian
lt - Lithuanian
mk - Macedonian
ms - Malay
ml - Malayalam
mt - Maltese
mn - Mongolian
ne - Nepali
no - Norwegian
fa - Persian
pl - Polish
pt - Portuguese
pa - Punjabi
ro - Romanian
ru - Russian
sr - Serbian
si - Sinhala
sk - Slovak
sl - Slovenian
es - Spanish
sw - Swahili
sv - Swedish
ta - Tamil
te - Telugu
th - Thai
tr - Turkish
uk - Ukrainian
ur - Urdu
vi - Vietnamese
cy - Welsh
